12,20
....................
.           s      .
. . . .... . ..... .
. . ... .. . .. .. .
. .   .    . ..    .
. ... ...... .......
.   .     .. .f.   .
. ....... .. . . . .
. .       .. .   . .
............ ..... .
.                  .
....................